111111111
1f00000P1
100000001
1000E0001
111111111
