1111111111111111111111111111111
1000010000C00000000000C1IIICCC1
1C00E10I000000I00010000100000C1
10111100000000000010000100IIIC1
1000000000000000001000010000001
1000000111111111001000010000001
1C00I00000C00C01I01000011100001
1C00000000C00C010010000CI000001
1111100000C00C010I1000000000001
1C00000000C00C010C1000000000001
1C00000011111111IC1000000000001
1C00000000C00C01IC1000ICI0000P1
1111111111111111111111111111111
