1111111111111
10C0000000001
1000110010001
1101010010C01
100C010000001
1011110110001
1011110000001
1P1011E000001
1111111111111
