11111111111
1C000000E01
100C0000001
100C00P0001
11111111111
